1111111
1P1C001
1000001
1100E11
1111111