11111111111111111111111111111111111111111111
1P0000011111000000000C0010000001001C10000001
10000001111000011111111110000001001000001011
10000000110000000010011100001000000111111001
10000011110000000000111111111000000000111101
1E000000000111111100000000000000011100000001
11111111111111111111111111111111111111111111