11111111111111
10000000010001
1P0C00000100E1
11111111111111